25 25
800 20
4 20 20 20 20 20 20 20 20 20 20 20 20 20 20 20 20 20 20 20 20 20 20 20 5
8 2  2  2  15  15  15  15  15  15  15  15  15  15  15  15  15  15  15  15  15  15  15  15  9
8 2  2  2  15  3   15  15  15  15  15  15  15  2  15  15  15  15  15  15  15  15  15  15  9
8 2  2  2  15  15  15  2   2   2  2  2  15  15  15  15  15  15  15  15  15  15  15  15  9
8 15 15 15 15  15  15  2   2   12 12 2  15  15  15  15  15  15  15  15  15  15  15  15  9
8 15 15 15 15  15  15  15  2   12 12 2  15  2  3  15  15  15  15  15  15  15  15  15  9
8 15 15 15 15  15  15  15  2   2  2  2  15  15  15  15  15  15  15  15  15  15  15  15  9
8 15 15 15 15  15  15  2   15  15  15  2  15  15  15  15  15  15  15  15  15  15  15  15  9
8 15 15 15 15  15  15  15  3   15  15  2  2  15  15  15  15  15  15  15  15  15  15  15  9
8 15 15 15 15  15  3   3   3   15  15  15  15  15  15  15  15  15  15  15  15  15  15  15  9
8 15 15 15 15  15  3   15 15  15  15  15  15  15  15  15  15  15  15  15  15  15  15  15  9
8 15 15 15 15 15  3   15 15  15  15  3  15  15  15  15  15  15  15  15  15  15  15  15  9
8 15 15 15 15 15  15  15 15  15  15  15  15  15  15  15  15  15  15  15  15  15  15  15  9
8 15 15 15 15 15  15  15 15  15  15  15  15  15  15  15  15  15  15  15  15  15  15  15  9
8 15 15 15 15 15  15  15 15  2  15  15  15  15  15  15  15  15  15  15  15  15  15  15  9
8 15 15 15 15 15  15  15 15  15  15  15  15  15  15  15  15  15  15  15  15  15  15  15  9
8 15 15 15 15 15  15  2  15  15  15  15  3  15  2  15  15  15  15  15  15  15  15  15  9
8 15 15 15 15 15  15  15 15  15  15  15  15  15  15  15  15  15  15  15  15  15  15  15  9
8 15 15 15 2  15  15  15 15  15  15  15  15  15  15  15  15  15  15  15  15  15  15  15  9
8 15 15 15 15 15  15  15 15  15  15  15  15  15  15  15  15  15  15  15  15  15  15  15  9
8 15 15 15 15 15  15  15 2  12 15  15  15  15  15  15  15  15  15  15  15  15  15  15  9
8 15 15 15 2  15  15  15 2  15  15  15  15  2  15  15  15  15  15  15  15  15  15  15  9
8 15 15 15 15 15  15  15 2  15  15  15  15  15  15  15  15  15  15  15  15  15  15  15  9
8 15 15 15 15 15  15  15 15  15  15  15  15  15  15  15  15  15  15  15  15  15  15  15  9
7 20 20 20 20 20 20 20 20 20 20 20 20 20 20 20 20 20 20 20 20 20 20 20 6