25 25
800 20
20 20 20 20 20 20 20 20 20 20 20 20 20 20 20 20 20 20 20 20 20 20 20 20 20
20 2  2  2  15 15 15 15 15 15 15 15 15 15 15 15 15 15 15 15 15 15 15 15 20
20 2  2  2  15 3  15 15 15 15 15 15 15 2  15 15 15 15 15 15 15 15 15 15 20
20 2  2  2  15 15 15 2  2  2  2  2  15 15 15 15 15 15 15 15 15 15 15 15 20
20 15 15 15 15 15 15 2  2  12 12 2  15 15 15 15 15 15 15 15 15 15 15 15 20
20 15 15 15 15 15 15 15 2  12 12 2  15 2  3  15 15 15 15 15 15 15 15 15 20
20 15 15 15 15 15 15 15 2  2  2  2  15 15 15 15 15 15 15 15 15 15 15 15 20
20 15 15 15 15 15 15 2  15 15 15 2  15 15 15 15 15 15 15 15 15 15 15 15 20
20 15 15 15 15 15 15 15 3  15 15 2  2  15 15 15 15 15 15 15 15 15 15 15 20
20 15 15 15 15 15 3  3  3  15 15 15 15 15 15 15 15 15 15 15 15 15 15 15 20
20 15 15 15 15 15 3  15 15 15 15 15 15 15 15 15 15 15 15 15 15 15 15 15 20
20 15 15 15 15 15 3  15 15 15 15 3  15 15 15 15 15 15 15 15 15 15 15 15 20
20 15 15 15 15 15 15 15 15 15 15 15 15 15 15 15 15 15 15 15 15 15 15 15 20
20 15 15 15 15 15 15 15 15 15 15 15 15 15 15 15 15 15 15 15 15 15 15 15 20
20 15 15 15 15 15 15 15 15 2  15 15 15 15 15 15 15 15 15 15 15 15 15 15 20
20 15 15 15 15 15 15 15 15 15 15 15 15 15 15 15 15 15 15 15 15 15 15 15 20
20 15 15 15 15 15 15 2  15 15 15 15 3  15 2  15 15 15 15 15 15 15 15 15 20
20 15 15 15 15 15 15 15 15 15 15 15 15 15 15 15 15 15 15 15 15 15 15 15 20
20 15 15 15 2  15 15 15 15 15 15 15 15 15 15 15 15 15 15 15 15 15 15 15 20
20 15 15 15 15 15 15 15 15 15 15 15 15 15 15 15 15 15 15 15 15 15 15 15 20
20 15 15 15 15 15 15 15 2  12 15 15 15 15 15 15 15 15 15 15 15 15 15 15 20
20 15 15 15 2  15 15 15 2  15 15 15 15 2  15 15 15 15 15 15 15 15 15 15 20
20 15 15 15 15 15 15 15 2  15 15 15 15 15 15 15 15 15 15 15 15 15 15 15 20
20 15 15 15 15 15 15 15 15 15 15 15 15 15 15 15 15 15 15 15 15 15 15 15 20
20 20 20 20 20 20 20 20 20 20 20 20 20 20 20 20 20 20 20 20 20 20 20 20 20