25 25
30 1200
21 21 21 21 21 21 21 21 21 21 21 21 21 21 21 21 21 21 21 21 21 21 21 21 21
21 21 21 21 21 21 21 21 21 21 21 21 24 24 24 24 24 24 24 24 21 21 21 21 21
21 21 21 21 21 21 21 21 21 21 21 24 24 26 26 26 26 26 26 24 24 21 21 21 21
21 21 21 21 21 21 21 21 21 21 21 24 26 25 27 25 27 25 27 26 24 21 21 21 21
21 21 21 21 21 21 21 21 21 21 21 24 26 27 25 27 25 27 25 26 24 21 21 21 21 
21 21 21 21 21 21 21 21 21 21 21 24 26 25 27 25 27 25 27 26 24 21 21 21 21
21 21 21 21 21 21 21 21 21 21 21 24 26 27 25 27 25 27 25 26 24 21 21 21 21
21 21 21 21 21 21 21 21 21 21 21 24 26 25 27 25 27 25 27 26 24 21 21 21 21
21 21 21 21 21 21 21 21 21 21 21 24 24 26 26 26 26 26 26 24 24 21 21 21 21
21 21 21 21 21 21 21 21 21 21 21 21 24 24 24 19 24 24 24 24 21 21 21 21 21
21 21 21 21 21 21 21 21 21 21 21 21 21 21 21 19 21 21 21 21 21 21 21 21 21
21 21 21 21 21 21 21 21 21 21 21 21 21 21 21 19 19 19 19 19 19 19 19 21 21
21 21 21 21 21 21 21 21 21 21 21 21 21 21 21 21 21 21 21 21 21 19 19 21 21  
21 33 33 33 33 33 33 33 33 33 33 33 33 33 33 33 33 21 21 21 19 19 19 21 21
21 33 33 34 34 34 34 34 34 34 34 34 34 34 34 34 33 33 21 21 21 19 19 21 21  
21 33 33 34 34 32 32 32 32 32 32 32 32 32 34 34 33 33 21 21 21 19 19 21 21  
21 33 33 34 32 32 31 31 31 31 31 31 31 32 32 34 33 33 21 21 21 19 19 21 21
21 33 33 34 32 31 30 30 29 29 30 30 31 32 32 34 18 18 18 18 18 18 18 21 21
21 33 33 34 32 31 30 29 29 29 29 30 31 31 32 34 18 18 18 18 18 18 18 21 21
21 33 33 34 32 31 30 30 29 29 30 30 31 31 32 34 33 33 21 21 21 21 21 21 21
21 33 33 34 32 32 32 31 31 31 31 31 31 32 32 34 33 33 21 21 21 21 21 21 21
21 33 33 34 34 32 32 32 32 32 32 32 32 32 34 34 33 33 21 21 21 21 21 21 21
21 33 33 34 34 34 34 34 34 34 34 34 34 34 34 34 33 33 21 21 21 21 21 21 21
21 33 33 33 33 33 33 33 33 33 33 33 33 33 33 33 33 21 21 21 21 21 21 21 21
21 21 21 21 21 21 21 21 21 21 21 21 21 21 21 21 21 21 21 21 21 21 21 21 21	