25 25
30 1200
10 10 10 10 10 10 10 10 10 10 10 10 10 10 10 10 10 10 10 10 10 10 10 10 10
10 10 10 10 10 10 10 10 10 10 10 10 10 10 10 10 10 10 10 26 26 26 26 10 10
10 10 10 10 10 10 10 10 10 10 10 10 10 10 10 10 10 10 10 26 26 26 26 10 10
10 10 10 10 10 10 10 10 10 10 10 10 10 10 10 10 10 10 10 26 27 27 26 10 10
10 10 10 10 10 10 10 10 10 10 10 10 10 10 10 10 10 10 10 24 24 24 24 10 10 
10 10 10 10 10 10 10 10 10 10 10 10 10 10 10 10 10 10 10 24 24 24 24 10 10
10 10 10 10 10 10 10 10 10 10 10 10 10 10 10 10 10 10 10 19 25 25 19 10 10
10 10 10 10 10 10 10 10 10 10 10 10 10 10 10 10 10 10 10 19 25 25 19 10 10
10 10 10 10 10 10 10 10 10 10 10 10 10 10 10 10 10 10 10 19 25 25 19 10 10
10 10 10 10 10 10 10 10 10 10 10 10 10 10 10 10 10 10 10 19 25 25 19 10 10
10 10 10 10 10 10 10 10 10 10 10 10 10 10 10 10 10 10 10 19 25 25 19 10 10
10 10 10 10 10 10 10 10 10 10 10 10 10 10 10 10 10 10 10 19 25 25 19 10 10
10 16 16 16 16 16 16 16 16 16 11 11 11 13 12 11 11 11 11 19 25 19 19 10 10  
10 16 16 16 16 16 16 16 16 16 11 11 11 13 12 11 11 11 11 10 22 23 23 10 10
10 16 16 16 16 16 16 16 16 16 11 11 11 13 12 11 11 11 11 18 18 18 22 18 10  
10 16 16 16 16 16 16 16 16 16 11 11 11 13 12 11 11 11 11 20 20 20 22 20 10  
10 16 16 16 16 16 16 16 16 16 2  2  2  2  2  2  2  2  2  19 19 19 1  19 10
10 15 15 15 15 15 15 15 15 15 4  4  4  4  4  4  4  4  4  9  9  9  9  9  10
10 15 0  15 15 15 15 15 15 15 4  4  4  4  4  4  4  4  4  9  9  9  9  9  10
10 9  9  9  9  9  9  9  9  9  4  4  4  4  4  4  4  4  4  9  9  9  9  9  10
10 9  9  9  9  9  9  9  9  9  4  4  4  4  4  4  4  4  4  9  9  9  9  9  10
10 15 15 15 15 15 15 15 15 15 21 6  21 6  6  21 21 6  6  15 15 15 15 15 10
10 11 11 11 11 11 11 11 11 11 21 21 21 21 21 21 21 21 21 17 17 17 17 17 10
10 11 11 11 11 11 11 11 11 11 21 8  21 8  21 8  21 21 8  17 17 17 17 17 10
10 10 10 10 10 10 10 10 10 10 10 10 10 10 10 10 10 10 10 10 10 10 10 10 10	