25 25
100 100
10 10 10 10 10 10 10 10 10 10 10 10 10 10 10 10 10 10 10 26 27 27 26 10 10
10 10 10 10 10 10 10 10 10 10 10 10 10 10 10 10 10 10 10 26 26 26 26 10 10
10 10 10 10 10 10 10 10 10 10 10 10 10 10 10 10 10 10 10 26 26 26 26 10 10
10 10 10 10 10 10 10 10 10 10 10 10 10 10 10 10 10 10 10 26 27 27 26 10 10
10 10 10 10 10 10 10 10 10 10 10 10 10 10 10 10 10 10 10 24 24 24 24 10 10 
10 10 10 10 10 10 10 10 10 10 10 10 10 10 10 10 10 10 10 24 24 24 24 10 10
10 10 10 10 10 10 10 10 10 10 10 10 10 10 10 10 10 10 10 19 25 25 19 10 10
10 10 10 10 10 10 10 10 10 10 10 10 10 10 10 10 10 10 10 19 25 25 19 10 10
10 10 10 10 10 10 10 10 10 10 10 10 10 10 10 10 10 10 10 19 25 25 19 10 10
10 10 10 10 10 10 10 10 10 10 10 10 10 10 10 10 10 10 10 19 25 25 19 10 10
10 10 10 10 10 10 10 10 10 10 10 10 10 10 10 10 10 10 10 19 25 25 19 10 10
10 10 10 10 10 10 10 10 10 10 10 10 10 10 10 10 10 10 10 19 25 25 19 10 10
16 16 16 16 16 16 16 16 16 16 11 11 11 13 12 11 11 11 11 19 25 19 19 10 10  
16 16 16 16 16 16 16 16 16 16 11 11 11 13 12 11 11 11 11 10 22 23 23 10 10
16 16 16 16 16 16 16 16 16 16 11 11 11 13 12 11 11 11 11 18 18 18 22 18 18  
16 16 16 16 16 16 16 16 16 16 11 11 11 13 12 11 11 11 11 20 20 20 22 20 20  
16 16 16 16 16 16 16 16 16 16 2  2  2  2  2  2  2  2  2  19 19 19 1  19 19
15 15 15 15 15 15 15 15 15 15 4  4  4  4  4  4  4  4  4  9  9  9  9  9  9
15 15 0  15 15 15 15 15 15 15 4  4  4  4  4  4  4  4  4  9  9  9  9  9  9
9  9  9  9  9  9  9  9  9  9  4  4  4  4  4  4  4  4  4  9  9  9  9  9  9
9  9  9  9  9  9  9  9  9  9  4  4  4  4  4  4  4  4  4  9  9  9  9  9  9
15 15 15 15 15 15 15 15 15 15 21 6  21 6  6  21 21 6  6  15 15 15 15 15 15
11 11 11 11 11 11 11 11 11 11 21 21 21 21 21 21 21 21 21 17 17 17 17 17 17
11 11 11 11 11 11 11 11 11 11 21 8  21 8  21 8  21 21 8  17 17 17 17 17 17
11 11 11 11 11 11 11 11 11 11 21 21 21 21 21 21 21 21 21 17 17 17 17 17 17	